1 15 1 15
E E
w w w w w w w w w w w w w w w w w w w w w w w w w w w w w w w w
w g g g g g w g w g g g g g w g g r g g w g w g g w g w g g g w
w g g g g g w g w g g g g g w g g g g g w g w g g w g w g g g w
w g g g g g w g w g g g g g w g g g g g w g w g g g g g g g g w
w g g g g g w g w g g g g g w g g g g 5 w g w g g g g g g g g w
w g g g g g g g g g g g g g g g g g g g w g w g g g g g g g g w
w w w w w w w g w w w w w w w w w g w w w g w g w w w w w w w w
w b g g g g g g g g g g g g g g g g g g g g g g g g g g g g g w
w w w w w w w g w w w w w w w w w g w w w g g w g g g g g g g w
w g g g g g g g g g g g g w g g g g g g w g g w g g g g g g g w
w g g g g g w g w g g g g w g g g g g g w g g w g w w w w w w w
w g g g g g w g w g g g g w g g g g g g w g g g g g g g g g g w
w g g g g g w g w w w w w w w w w w w w w g g g g g w g g g g w
w g g g g g w g w g g g g w g g g w g g w g g g g g w g g g g w
w w w w w w w g w g w g g w g g g w g g w g g g g g w g g g g w
w g g g g g g g g g w g g w g w w w g g g g g g g g w g g g g w
w w g w g w w g w g w g g w g w g g g g w w w w w g w w w w w w
w g g w g g w g w g w g g w g w g g w g w g g g g g g g g g g w
w 2 g w g g w g w g w g g w g w 1 g w g w w g g g g g g g 3 g w
w g g w g g w g w g w g g w g w w w w g w g g g g g g g g g g w
w g g w g g w g w g w g g g g g g g g g w g g g g g g g g g g w
w w w w w w w g w w w w w w w w w w w w w w w w w w w w w w w w
w o g g g g w p w g g g g g g g w g w g w g g g g g g g g g g w
w g g g g g w w w g g g g g g g w g w g g g g w g w g w g w g w
w g g g g g w w w w w w g w w w w g w w w g g w g w g w g w 9 w
w g g g g g w w w g g g g g g g g g g g g g g g g g g g g g g w
w g g g g g g g g g g g g g g g w w w w w w g w w w w w w w w w
w g 0 g g g w w w g g g g g g g g g g g g g g w g g g g g 8 g w
w g g g g g w w w w w w g w w w w g g g g g g g g g g g g g g w
w g g g 4 g w w w g g 6 g g g g w g g g g 7 g w g g g g g g g w
w g g g g g w w w g g g g g g g w g g g g g g w g g g y g g g w
w w w w w w w w w w w w w w w w w w w w w w w w w w w w w w w w