20 29 20 29
E E
w w w w w w w w w w w w w w w w w w w w w w w w w w w w w w w w
w g g g g g g w g g g g g g g g g p g g g g g g g g g g g g g w
w g w g w w g w g w g w g w g w g g g g g g g g g g g g g g g w
w g g g g g g w 6 w 5 w 4 w g w g g g g w w w w w w w w w g g w
w g w g w w w w g w g w g w g w g g g g w g g g g g g w w g g w
w g g g g g g w g g g g g g g w g g g g w g g g g g g w w g g w
w g w g w w w w g w w w w w w w g g g g w g g w w g g g g g g w
w g g g g g g w g g g g g g g g g g g g w g g w w g g g g g g w
w g w g w w w w w w w g w w w w g g g g w g g w w w w w g g g w
w g g g g g g g g g w g w g g g g g g g w g g w w w w w g g g w
w g w g w w w g w g g g w g w w w w w w w g g g g g g g g g g w
w g g g w g w g w g w g w g w g g g g g g g g g g g 8 g g g g w
w g w g w g w w w g w g w g w g g g g g g g g g g g g g g g g w
w g g g w g g 7 g g w g w g w g g g g g g g g g w w w w w w g w
w g w g w g w w w g w g w g g g g w g w w w w g w g g g g g g w
w g g g g g g g w g w g w g w g g w g w g g w g w g g w g w g w
w g w g w g w w w g w w w g w g g w g w g 9 w g w g g w g w g w
w g g g g g g w g g g g g g g g g w g g g g w g w g g w g w g w
w g w g w g w w g g w w g g w w g w w w w w w g w g g w g w g w
w g g g g g g w g g w g g g g g g g g g g g g g w g g w g w g w
w g w w w w w w g g w w w g w w w w g w w w w g w w w w w w g w
w g g g g g g g g g w g w g g g g g g g g g g g w 0 g g g g g w
w w w w w w g w w w w g w g g g g w g g g g g g w 1 g g g g g w
w g g g g w g g g g g g w g g g g w g g g g g g w 2 g g g g g w
w g g g g w g g g g g g w g g g g w g g g g g g w 3 g g g g g w
w g g g g w g g g g g g w g g g g g g g g g g g w g g g g g g w
w w g w w w w w w g w w w w w w g w w w w w w g g g w w w w w w
w g g g g w g g g g g g w g g g g w g g g g g g w g g g g g g w
w g g g g w g g g g g g w g g g g w g g g g g g w g g g g g g w
w g g g b w g g g g g g w g g g g w g r g y g g w g g g g g g w
w g g g g g g g g g g g g g g g g w g g o g g g w g g g g g g w
w w w w w w w w w w w w w w w w w w w w w w w w w w w w w w w w