1 1 1 1
E E
w w w w w w w w w w w w w w w w w w w w w w w w w w w w w w w w
w g g g g g g g g g 9 g g g g g g g g g g g g g g g g g g g g w
w w w w g g g g g g g g g g g g g g g w g g g g g g g g g g g w
w g g w g g g g g g g g g g g g g g g w g g g g g g g g g g g w
w g g w w w g g g g g g g g g g g g g w g g g g g g g g g g g w
w g g g g w g g g g g g g g g g g g g w g g g g g g g g g g g w
w g g g g w w w g g g g g g g p g g g w g g g g g g g g g g g w
w g g g g g g w g w w w w w w w w w w w w w w g g g g g g g g w
w g g g g g g g g g w g g g g w g g r w g g w g g g g 8 g g g w
w g g g g g g g g g w w g w w w g w w w g w w g g g g g g g g w
w g g g g g g g g g w g g g g g g g g g g g w g g 7 g g g g g w
w w g w w w w w w w w w w g w w g w w w w w w g g g g g g g g w
w g g g g g g g g g w g g g g w g w g g g g w g g g g g g g g w
w g g g g g g g g g w 0 g g g w g w g g g g w g g g g g g g b w
w g g g g g g g g g w w w w w w g w w w g w w w w w w w w w w w
w g g g g g g g g g w g g g g g y g g g g g w g g g g g g g g w
w g g g g g g g g g w w w w w w g w g w w w w g 2 g g g g g g w
w g g g g g g g g g w g g g g w g w g g g g w g g g g g g g g w
w g g g g g g g g g w g g g g w g w g g g g w g g g g 4 g g g w
w g g g 1 g g g g g w g g g g w g w g 6 g g w g g g g g g g g w
w g g g g g g g g g w g g g g g g w g g g g w g g 3 g g g g g w
w g g g g g g g g g w g g g g w g w g g g g w g g g g g g g g w
w g g g g g g g g g w w w w w w w w w w w w w w w g w w w w w w
w g g g g g g g w w g g g g g g g g g g w g g g g g g g g g g w
w g g g g g g w w g g g g g g g g 5 g g w g g g g g g g g g g w
w g g g g g w w g g g g g g g g g g g g g g g g g g g g g g g w
w g g g w g w g g g g g g g g g g g g g w g g g g g g g g g g w
w g g w w g g g g g g g g g g g g g g g w g g g g g g g g g g w
w g w w g g g g g g g g g g g g g g g g g g g g g g g g g g g w
w w w o g g g g g g g g g g g g g g g g w g g g g g g g g g g w
w g g g g g g g g g g g g g g g g g g g w g g g g g g g g g g w
w w w w w w w w w w w w w w w w w w w w w w w w w w w w w w w w